XXXXXXXXXXXXXXXXXXXXXXXXXXXXXXXXXXXXXXXXXXXXXXXXXXXXXXXXXXXXXXXXXXXXXXXXXXXXXXXXXXXXXXXXXXXXXXXXXXXXXXXX
XX                      XXX                       XXX                        XXX                      XX
X                        X                         X                          X                        X
X                                                                                                      X
X                        X                         X                          X                        X
XX                       X                         X                          X                       XX
XXX                    XXXXX                     XXXXX                      XXXXX                    XXX
XX                       X                         X                          X                       XX
X                        X                         X                          X                        X
X                                                                                                      X
X                        X                         X                          X                        X
X                        X                         X                          X                        X
X                       XXX                       XXX                        XXX                       X
XXX                   XXXXXXX                   XXXXXXX                    XXXXXXX                   XXX
XXX                   XXXXXXX                   XXXXXXX                    XXXXXXX                   XXX
X                       XXX                       XXX                        XXX                       X
X                        X                         X                          X                        X
X                        X                         X                          X                        X
X                                                                                                      X
X                        X                         X                          X                        X
XX                       X                         X                          X                       XX
XXX                    XXXXX                     XXXXX                      XXXXX                    XXX
XX                       X                         X                          X                       XX
X                        X                         X                          X                        X
X                                                                                                      X
X                        X                         X                          X                        X
X                        X                         X                          X                        X
X                      XXXXX                     XXXXX                      XXXXX                      X
X                        X                         X                          X                        X
X                        X                         X                          X                        X
X                                                                                                      X
X                        X                         X                          X                        X
XX                       X                         X                          X                       XX
XXX                    XXXXX                     XXXXX                      XXXXX                    XXX
XX                       X                         X                          X                       XX
X                        X                         X                          X                        X
X                                                                                                      X
X                        X                         X                          X                        X
X                        X                         X                          X                        X
X                       XXX                       XXX                        XXX                       X
XXX                   XXXXXXX                   XXXXXXX                    XXXXXXX                   XXX
XXX                   XXXXXXX                   XXXXXXX                    XXXXXXX                   XXX
X                       XXX                       XXX                        XXX                       X
X                        X                         X                          X                        X
X                        X                         X                          X                        X
X                                                                                                      X
X                        X                         X                          X                        X
XX                       X                         X                          X                       XX
XXX                    XXXXX                     XXXXX                      XXXXX                    XXX
XX                       X                         X                          X                       XX
X                        X                         X                          X                        X
X                                                                                                      X
X                        X                         X                          X                        X
XX                      XXX                       XXX                        XXX                      XX
XXXXXXXXXXXXXXXXXXXXXXXXXXXXXXXXXXXXXXXXXXXXXXXXXXXXXXXXXXXXXXXXXXXXXXXXXXXXXXXXXXXXXXXXXXXXXXXXXXXXXXXX