XXXXXXXXXXXXXXXXXXXXXXXXXXXXXXXXXXXXXXXXXXXXXXXXXXXXXXXXXXXXXXXXXXXXXXXXXXXXXXXXXXXXXXXXXXXXXXXXXXXXXXXX
X                                                  X                                                   X
X                                                  X                                                   X
X                                                  X                                                   X
X                                                  X                                                   X
X                                                  X                                                   X
X                                                  X                                                   X
X                                                  X                                                   X
X                                                  X                                                   X
X                                                  X                                                   X
X                                                  X                                                   X
X                                                  X                                                   X
X                                                  X                                                   X
X                                                  X                                                   X
X                                                  X                                                   X
X                                                  X                                                   X
X                                                  X                                                   X
X                                                  X                                                   X
X                                                  X                                                   X
X                                                  X                                                   X
X                                                  X                                                   X
X                                                  X                                                   X
X                                                                                                      X
X                                                                                                      X
X                                                                                                      X
XXXXXXXXXXXXXXXXXXXXXXXXXX                                                    XXXXXXXXXXXXXXXXXXXXXXXXXX
X                                                                                                      X
XXXXXXXXXXXXXXXXXXXXXXXXXX                                                    XXXXXXXXXXXXXXXXXXXXXXXXXX
X                                                                                                      X
X                                                                                                      X
X                                                                                                      X
X                                                  X                                                   X
X                                                  X                                                   X
X                                                  X                                                   X
X                                                  X                                                   X
X                                                  X                                                   X
X                                                  X                                                   X
X                                                  X                                                   X
X                                                  X                                                   X
X                                                  X                                                   X
X                                                  X                                                   X
X                                                  X                                                   X
X                                                  X                                                   X
X                                                  X                                                   X
X                                                  X                                                   X
X                                                  X                                                   X
X                                                  X                                                   X
X                                                  X                                                   X
X                                                  X                                                   X
X                                                  X                                                   X
X                                                  X                                                   X
X                                                  X                                                   X
X                                                  X                                                   X
X                                                  X                                                   X
XXXXXXXXXXXXXXXXXXXXXXXXXXXXXXXXXXXXXXXXXXXXXXXXXXXXXXXXXXXXXXXXXXXXXXXXXXXXXXXXXXXXXXXXXXXXXXXXXXXXXXXX