XXXXXXXXXXXXXXXXXXXXXXXXXXXXXXXXXXXXXXXXXXXXXXXXXXXXXXXXXXXXXXXXXXXXXXXXXXXXXXXXXXXXXXXXXXXXXXXXXXXXXXXX
X                                                 X X                                                  X
X                                                 X X                                                  X
X                                                 X X                                                  X
X                                                 X X                                                  X
X                                                 X X                                                  X
X                                                 X X                                                  X
X                                                 X X                                                  X
X                                                 X X                                                  X
X                                                 X X                                                  X
X                                                 X X                                                  X
X                                                 X X                                                  X
X                                                 X X                                                  X
X                                                 X X                                                  X
X                                                 X X                                                  X
X                                                 X X                                                  X
X                                                 X X                                                  X
X                                                 X X                                                  X
X                                                 X X                                                  X
X                X                                X X                                 X                X
X                X                                X X                                 X                X
X                X                                X X                                 X                X
X                X                                X X                                 X                X
X                X                                X X                                 X                X
X                X                                                                    X                X
X                XXXXXXXXXXXXXXXXXXXXXXXXXXXXXXXXXXXXXXXXXXXXXXXXXXXXXXXXXXXXXXXXXXXXXX                X
X                                                                                                      X
X                                                                                                      X
X                                                                                                      X
X                XXXXXXXXXXXXXXXXXXXXXXXXXXXXXXXXXXXXXXXXXXXXXXXXXXXXXXXXXXXXXXXXXXXXXX                X
X                X                                                                    X                X
X                X                                X X                                 X                X
X                X                                X X                                 X                X
X                X                                X X                                 X                X
X                X                                X X                                 X                X
X                X                                X X                                 X                X
X                                                 X X                                                  X
X                                                 X X                                                  X
X                                                 X X                                                  X
X                                                 X X                                                  X
X                                                 X X                                                  X
X                                                 X X                                                  X
X                                                 X X                                                  X
X                                                 X X                                                  X
X                                                 X X                                                  X
X                                                 X X                                                  X
X                                                 X X                                                  X
X                                                 X X                                                  X
X                                                 X X                                                  X
X                                                 X X                                                  X
X                                                 X X                                                  X
X                                                 X X                                                  X
X                                                 X X                                                  X
X                                                 X X                                                  X
XXXXXXXXXXXXXXXXXXXXXXXXXXXXXXXXXXXXXXXXXXXXXXXXXXXXXXXXXXXXXXXXXXXXXXXXXXXXXXXXXXXXXXXXXXXXXXXXXXXXXXXX