XXXXXXXXXXXXXXXXXXXXXXXXXXXXXXXXXXXXXXXXXXXXXXXXXXXXXXXXXXXXXXXXXXXXXXXXXXXXXXXXXXXXXXXXXXXXXXXXXXXXXXXX
X                        X                         X                          X                        X
X                        X                         X                          X                        X
X                        X                         X                          X                        X
X                        X                         X                          X                        X
X                        X                         X                          X                        X
X                        X                         X                          X                        X
X                        X                         X                          X                        X
X                        X                         X                          X                        X
X                        X                         X                          X                        X
X                        X                         X                          X                        X
X                        X                         X                          X                        X
X                        X                         X                          X                        X
X                        X                         X                          X                        X
X                                                                                                      X
X                        X                         X                          X                        X
X                        X                         X                          X                        X
X                        X                         X                          X                        X
X                        X                         X                          X                        X
X                        X                         X                          X                        X
X                        X                         X                          X                        X
X                        X                         X                          X                        X
X                        X                         X                          X                        X
X                        X                         X                          X                        X
X                        X                         X                          X                        X
X                        X                         X                          X                        X
X                        X                         X                          X                        X
X                                                                                                      X
X                        X                         X                          X                        X
X                        X                         X                          X                        X
X                        X                         X                          X                        X
X                        X                         X                          X                        X
X                        X                         X                          X                        X
X                        X                         X                          X                        X
X                        X                         X                          X                        X
X                        X                         X                          X                        X
X                        X                         X                          X                        X
X                        X                         X                          X                        X
X                        X                         X                          X                        X
X                        X                         X                          X                        X
X                                                                                                      X
X                        X                         X                          X                        X
X                        X                         X                          X                        X
X                        X                         X                          X                        X
X                        X                         X                          X                        X
X                        X                         X                          X                        X
X                        X                         X                          X                        X
X                        X                         X                          X                        X
X                        X                         X                          X                        X
X                        X                         X                          X                        X
X                        X                         X                          X                        X
X                        X                         X                          X                        X
X                        X                         X                          X                        X
X                        X                         X                          X                        X
XXXXXXXXXXXXXXXXXXXXXXXXXXXXXXXXXXXXXXXXXXXXXXXXXXXXXXXXXXXXXXXXXXXXXXXXXXXXXXXXXXXXXXXXXXXXXXXXXXXXXXXX