XXXXXXXXXXXXXXXXXXXXXXXXXXXXXXXXXXXXXXXXXXXXXXXXXXXXXXXXXXXXXXXXXXXXXXXXXXXXXXXXXXXXXXXXXXXXXXXXXXXXXXXX
X                                                                                                      X
X                                                                                                      X
X                                                                                                      X
X                                                                                                      X
X                                                                                                      X
X                                                                                                      X
X                                                                                                      X
X                                                                                                      X
X                               XXXXXXXXXXXXXXXXXXXXXXXXXXXXXXXXXXXXXXX                                X
X                                                                                                      X
X                                                                                                      X
X                                                                                                      X
X                                                                                                      X
X                                                                                                      X
X                                                                                                      X
X                                                                                                      X
X                                                                                                      X
X                                                                                                      X
X                                                                                                      X
X                                                                                                      X
X                                                                                                      X
X                                                                                                      X
X                                                                                                      X
X                                                                                                      X
X                                                                                                      X
X                                                                                                      X
X                                                                                                      X
X                                                                                                      X
X                                                                                                      X
X                                                                                                      X
X                                                                                                      X
X                                                                                                      X
X                                                                                                      X
X                                                                                                      X
X                                                                                                      X
X                                                                                                      X
X                                                                                                      X
X                                                                                                      X
X                                                                                                      X
X                                                                                                      X
X                                                                                                      X
X                                                                                                      X
X                                                                                                      X
X                               XXXXXXXXXXXXXXXXXXXXXXXXXXXXXXXXXXXXXXX                                X
X                                                                                                      X
X                                                                                                      X
X                                                                                                      X
X                                                                                                      X
X                                                                                                      X
X                                                                                                      X
X                                                                                                      X
X                                                                                                      X
X                                                                                                      X
XXXXXXXXXXXXXXXXXXXXXXXXXXXXXXXXXXXXXXXXXXXXXXXXXXXXXXXXXXXXXXXXXXXXXXXXXXXXXXXXXXXXXXXXXXXXXXXXXXXXXXXX