XXXXXXXXXXXXXXXXXXXXXXXXXXXXXXXXXXXXXXXXXXXXXXXXXXXXXXXXXXXXXXXXXXXXXXXXXXXXXXXXXXXXXXXXXXXXXXXXXXXXXXXX
X                                                                                                      X
X                                                                                                      X
X                                                                                                      X
X   XXXXXXXXXXXXXXXXXXXXXXXXXXXXXXXXXXXXXXXXXXXXXXXXXXXXXXXXXXXXXXXXXXXXXXXXXXXXXXXXXXXXXXXXXXXXXXXX   X
X   X                                                                                              X   X
X   X                                                                                              X   X
X   X                                                                                              X   X
X   X                                                                                              X   X
X   X                                                                                              X   X
X   X                                                                                              X   X
X   X                                                                                              X   X
X   X                                                                                              X   X
X                                                                                                      X
X                                                                                                      X
X                                                                                                      X
X   X                                                                                              X   X
X   X                                                                                              X   X
X   X                                                                                              X   X
X   X                                                                                              X   X
X   X                                                                                              X   X
X   X                                                                                              X   X
X   X                                                                                              X   X
X   X                                                                                              X   X
X   XXXXXXXXXXXXXXXXXXXXXXXXXXXXXXXXXXXXXXXXXXXXXXXXXXXXXXXXXXXXXXXXXXXXXXXXXXXXXXXXXXXXXXXXXXXXXXXX   X
X                                                                                                      X
X                                                                                                      X
X                                                                                                      X
X                                                                                                      X
X                                                                                                      X
X   XXXXXXXXXXXXXXXXXXXXXXXXXXXXXXXXXXXXXXXXXXXXXXXXXXXXXXXXXXXXXXXXXXXXXXXXXXXXXXXXXXXXXXXXXXXXXXXX   X
X   X                                                                                              X   X
X   X                                                                                              X   X
X   X                                                                                              X   X
X   X                                                                                              X   X
X   X                                                                                              X   X
X   X                                                                                              X   X
X   X                                                                                              X   X
X   X                                                                                              X   X
X                                                                                                      X
X                                                                                                      X
X                                                                                                      X
X   X                                                                                              X   X
X   X                                                                                              X   X
X   X                                                                                              X   X
X   X                                                                                              X   X
X   X                                                                                              X   X
X   X                                                                                              X   X
X   X                                                                                              X   X
X   X                                                                                              X   X
X   XXXXXXXXXXXXXXXXXXXXXXXXXXXXXXXXXXXXXXXXXXXXXXXXXXXXXXXXXXXXXXXXXXXXXXXXXXXXXXXXXXXXXXXXXXXXXXXX   X
X                                                                                                      X
X                                                                                                      X
X                                                                                                      X
XXXXXXXXXXXXXXXXXXXXXXXXXXXXXXXXXXXXXXXXXXXXXXXXXXXXXXXXXXXXXXXXXXXXXXXXXXXXXXXXXXXXXXXXXXXXXXXXXXXXXXXX