XXXXXXXXXXXXXXXXXXXXXXXXXXXXXXXXXXXXXXXXXXXXXXXXXXXXXXXXXXXXXXXXXXXXXXXXXXXXXXXXXXXXXXXXXXXXXXXXXXXXXXXX
X                                                                                                      X
X                                                                                                      X
X                                                                                                      X
X                                                                                                      X
X                                                                                                      X
X                                                                                                      X
X                                                                                                      X
X                                                                                                      X
X                                                                                                      X
X                                                                                                      X
X                                                                                                      X
X                                                                                                      X
XXXXXXXXXXXXXXXXXXXXXXXXX XXXXXXXXXXXXXXXXXXXXXXXXX XXXXXXXXXXXXXXXXXXXXXXXXXX XXXXXXXXXXXXXXXXXXXXXXXXX
XXXXXXXXXXXXXXXXXXXXXXXXX XXXXXXXXXXXXXXXXXXXXXXXXX XXXXXXXXXXXXXXXXXXXXXXXXXX XXXXXXXXXXXXXXXXXXXXXXXXX
X                                                                                                      X
X                                                                                                      X
X                                                                                                      X
X                                                                                                      X
X                                                                                                      X
X                                                                                                      X
X                                                                                                      X
X                                                                                                      X
X                                                                                                      X
X                                                                                                      X
X                                                                                                      X
X                       X                                                      X                       X
X                      XXX                                                    XXX                      X
X                       X                                                      X                       X
X                                                                                                      X
X                                                                                                      X
X                                                                                                      X
X                                                                                                      X
X                                                                                                      X
X                                                                                                      X
X                                                                                                      X
X                                                                                                      X
X                                                                                                      X
X                                                                                                      X
X                                                                                                      X
XXXXXXXXXXXXXXXXXXXXXXXXX XXXXXXXXXXXXXXXXXXXXXXXXX XXXXXXXXXXXXXXXXXXXXXXXXXX XXXXXXXXXXXXXXXXXXXXXXXXX
XXXXXXXXXXXXXXXXXXXXXXXXX XXXXXXXXXXXXXXXXXXXXXXXXX XXXXXXXXXXXXXXXXXXXXXXXXXX XXXXXXXXXXXXXXXXXXXXXXXXX
X                                                                                                      X
X                                                                                                      X
X                                                                                                      X
X                                                                                                      X
X                                                                                                      X
X                                                                                                      X
X                                                                                                      X
X                                                                                                      X
X                                                                                                      X
X                                                                                                      X
X                                                                                                      X
X                                                                                                      X
XXXXXXXXXXXXXXXXXXXXXXXXXXXXXXXXXXXXXXXXXXXXXXXXXXXXXXXXXXXXXXXXXXXXXXXXXXXXXXXXXXXXXXXXXXXXXXXXXXXXXXXX