XXXXXXXXXXXXXXXXXXXXXXXXXXXXXXXXXXXXXXXXXXXXXXXXXXXXXXXXXXXXXXXXXXXXXXXXXXXXXXXXXXXXXXXXXXXXXXXXXXXXXXXX
X   XX                                                                                                 X
X   XX                                                                                                 X
X   XX                                                                                                 X
X   XX   XXXXXXXXXXXXXXXXXXXXXXXXXXXXXXXXXXXXXXXXXXXXXXXXXXXXXXXXXXXXXXXXXXXXXXXXXXXXXXXXXXXXXXXXXXXXXXX
X   XX   XXXXXXXXXXXXXXXXXXXXXXXXXXXXXXXXXXXXXXXXXXXXXXXXXXXXXXXXXXXXXXXXXXXXXXXXXXXXXXXXXXXXXXXXXXXXXXX
X   XX   XX                                                                                            X
X   XX   XX                                                                                            X
X   XX   XX                                                                                            X
X   XX   XX   XXXXXXXXXXXXXXXXXXXXXXXXXXXXXXXXXXXXXXXXXXXXXXXXXXXXXXXXXXXXXXXXXXXXXXXXXXXXXXXXXXXXXXXXXX
X   XX   XX   XXXXXXXXXXXXXXXXXXXXXXXXXXXXXXXXXXXXXXXXXXXXXXXXXXXXXXXXXXXXXXXXXXXXXXXXXXXXXXXXXXXXXXXXXX
X   XX   XX   XX                                                                                       X
X   XX   XX   XX                                                                                       X
X   XX   XX   XX                                                                                       X
X   XX   XX   XX   XXXXXXXXXXXXXXXXXXXXXXXXXXXXXXXXXXXXXXXXXXXXXXXXXXXXXXXXXXXXXXXXXXXXXXXXXXXXXXXXXXXXX
X   XX   XX   XX   XXXXXXXXXXXXXXXXXXXXXXXXXXXXXXXXXXXXXXXXXXXXXXXXXXXXXXXXXXXXXXXXXXXXXXXXXXXXXXXXXXXXX
X   XX   XX   XX   XX                                                                                  X
X   XX   XX   XX   XX                                                                                  X
X   XX   XX   XX   XX                                                                                  X
X   XX   XX   XX   XX   XXXXXXXXXXXXXXXXXXXXXXXXXXXXXXXXXXXXXXXXXXXXXXXXXXXXXXXXXXXXXXXXXXXXXXXXXXXXXXXX
X   XX   XX   XX   XX   XXXXXXXXXXXXXXXXXXXXXXXXXXXXXXXXXXXXXXXXXXXXXXXXXXXXXXXXXXXXXXXXXXXXXXXXXXXXXXXX
X   XX   XX   XX   XX   XX                                                                             X
X   XX   XX   XX   XX   XX                                                                             X
X   XX   XX   XX   XX   XX                                                                             X
X   XX   XX   XX   XX   XX   XXXXXXXXXXXXXXXXXXXXXXXXXXXXXXXXXXXXXXXXXXXXXXXXXXXXXXXXXXXXXXXXXXXXXXXXXXX
X   XX   XX   XX   XX   XX   XXXXXXXXXXXXXXXXXXXXXXXXXXXXXXXXXXXXXXXXXXXXXXXXXXXXXXXXXXXXXXXXXXXXXXXXXXX
X   XX   XX   XX   XX   XX   XX                                                                        X
X   XX   XX   XX   XX   XX   XX                                                                        X
X   XX   XX   XX   XX   XX   XX                                                                        X
X   XX   XX   XX   XX   XX   XX   XXXXXXXXXXXXXXXXXXXXXXXXXXXXXXXXXXXXXXXXXXXXXXXXXXXXXXXXXXXXXXXXXXXXXX
X   XX   XX   XX   XX   XX   XX   XXXXXXXXXXXXXXXXXXXXXXXXXXXXXXXXXXXXXXXXXXXXXXXXXXXXXXXXXXXXXXXXXXXXXX
X   XX   XX   XX   XX   XX   XX   XX                                                                   X
X   XX   XX   XX   XX   XX   XX   XX                                                                   X
X   XX   XX   XX   XX   XX   XX   XX                                                                   X
X   XX   XX   XX   XX   XX   XX   XX   XXXXXXXXXXXXXXXXXXXXXXXXXXXXXXXXXXXXXXXXXXXXXXXXXXXXXXXXXXXXXXXXX
X   XX   XX   XX   XX   XX   XX   XX   XXXXXXXXXXXXXXXXXXXXXXXXXXXXXXXXXXXXXXXXXXXXXXXXXXXXXXXXXXXXXXXXX
X   XX   XX   XX   XX   XX   XX   XX   XX                                                              X
X   XX   XX   XX   XX   XX   XX   XX   XX                                                              X
X   XX   XX   XX   XX   XX   XX   XX   XX                                                              X
X   XX   XX   XX   XX   XX   XX   XX   XX                                                              X
X   XX   XX   XX   XX   XX   XX   XX   XX                                                              X
X   XX   XX   XX   XX   XX   XX   XX   XX                                                              X
X   XX   XX   XX   XX   XX   XX   XX   XX                                                              X
X   XX   XX   XX   XX   XX   XX   XX   XX                                                              X
X   XX   XX   XX   XX   XX   XX   XX   XX                                                              X
X   XX   XX   XX   XX   XX   XX   XX   XX                                                              X
X   XX   XX   XX   XX   XX   XX   XX   XX                                                              X
X   XX   XX   XX   XX   XX   XX   XX   XX                                                              X
X   XX   XX   XX   XX   XX   XX   XX   XX                                                              X
X   XX   XX   XX   XX   XX   XX   XX   XX                                                              X
X   XX   XX   XX   XX   XX   XX   XX   XX                                                              X
X                                                                                                      X
X                                                                                                      X
X                                                                                                      X
XXXXXXXXXXXXXXXXXXXXXXXXXXXXXXXXXXXXXXXXXXXXXXXXXXXXXXXXXXXXXXXXXXXXXXXXXXXXXXXXXXXXXXXXXXXXXXXXXXXXXXXX