XXXXXXXXXXXXXXXXXXXXXXXXXXXXXXXXXXXXXXXXXXXXXXXXXXXXXXXXXXXXXXXXXXXXXXXXXXXXXXXXXXXXXXXXXXXXXXXXXXXXXXXX
X                        X                         X                          X                        X
X                                                                                                      X
X                                                                                                      X
X                                                                                                      X
X                        X                         X                          X                        X
XX                      XXX                       XXX                        XXX                      XX
X                        X                         X                          X                        X
X                                                                                                      X
X                                                                                                      X
X                                                                                                      X
X                        X                         X                          X                        X
X                        X                         X                          X                        X
XX                     XXXXX                     XXXXX                      XXXXX                     XX
XX                     XXXXX                     XXXXX                      XXXXX                     XX
X                        X                         X                          X                        X
X                        X                         X                          X                        X
X                                                                                                      X
X                                                                                                      X
X                                                                                                      X
X                        X                         X                          X                        X
XX                      XXX                       XXX                        XXX                      XX
X                        X                         X                          X                        X
X                                                                                                      X
X                                                                                                      X
X                                                                                                      X
X                        X                                                    X                        X
X                       XXX                                                  XXX                       X
X                        X                                                    X                        X
X                                                                                                      X
X                                                                                                      X
X                                                                                                      X
X                        X                         X                          X                        X
XX                      XXX                       XXX                        XXX                      XX
X                        X                         X                          X                        X
X                                                                                                      X
X                                                                                                      X
X                                                                                                      X
X                        X                         X                          X                        X
X                        X                         X                          X                        X
XX                     XXXXX                     XXXXX                      XXXXX                     XX
XX                     XXXXX                     XXXXX                      XXXXX                     XX
X                        X                         X                          X                        X
X                        X                         X                          X                        X
X                                                                                                      X
X                                                                                                      X
X                                                                                                      X
X                        X                         X                          X                        X
XX                      XXX                       XXX                        XXX                      XX
X                        X                         X                          X                        X
X                                                                                                      X
X                                                                                                      X
X                                                                                                      X
X                        X                         X                          X                        X
XXXXXXXXXXXXXXXXXXXXXXXXXXXXXXXXXXXXXXXXXXXXXXXXXXXXXXXXXXXXXXXXXXXXXXXXXXXXXXXXXXXXXXXXXXXXXXXXXXXXXXXX