XXXXXXXXXXXXXXXXXXXXXXXXXXXXXXXXXXXXXXXXXXXXXXXXXXXXXXXXXXXXXXXXXXXXXXXXXXXXXXXXXXXXXXXXXXXXXXXXXXXXXXXX
X                        X                         X                          X                        X
X                        X                         X                          X                        X
X                        X                         X                          X                        X
X                        X                         X                          X                        X
X                        X                         X                          X                        X
X                        X                         X                          X                        X
X                        X                         X                          X                        X
X                        X                         X                          X                        X
X                        X                         X                          X                        X
X                        X                         X                          X                        X
X                        X                         X                          X                        X
X                        X                         X                          X                        X
XXXXXXXXXXXXXXXXXXXXXXXX   XXXXXXXXXXXXXXXXXXXXXXX   XXXXXXXXXXXXXXXXXXXXXXXX   XXXXXXXXXXXXXXXXXXXXXXXX
XXXXXXXXXXXXXXXXXXXXXXXX   XXXXXXXXXXXXXXXXXXXXXXX   XXXXXXXXXXXXXXXXXXXXXXXX   XXXXXXXXXXXXXXXXXXXXXXXX
X                        X                         X                          X                        X
X                        X                         X                          X                        X
X                        X                         X                          X                        X
X                        X                         X                          X                        X
X                        X                         X                          X                        X
X                        X                         X                          X                        X
X                        X                         X                          X                        X
X                        X                         X                          X                        X
X                        X                         X                          X                        X
X                        X                         X                          X                        X
X                        X                         X                          X                        X
X                        X                         X                          X                        X
X                            XXXXXXXXXXXXXXX               XXXXXXXXXXXXXXXX                            X
X                        X                         X                          X                        X
X                        X                         X                          X                        X
X                        X                         X                          X                        X
X                        X                         X                          X                        X
X                        X                         X                          X                        X
X                        X                         X                          X                        X
X                        X                         X                          X                        X
X                        X                         X                          X                        X
X                        X                         X                          X                        X
X                        X                         X                          X                        X
X                        X                         X                          X                        X
X                        X                         X                          X                        X
XXXXXXXXXXXXXXXXXXXXXXXX   XXXXXXXXXXXXXXXXXXXXXXX   XXXXXXXXXXXXXXXXXXXXXXXX   XXXXXXXXXXXXXXXXXXXXXXXX
XXXXXXXXXXXXXXXXXXXXXXXX   XXXXXXXXXXXXXXXXXXXXXXX   XXXXXXXXXXXXXXXXXXXXXXXX   XXXXXXXXXXXXXXXXXXXXXXXX
X                        X                         X                          X                        X
X                        X                         X                          X                        X
X                        X                         X                          X                        X
X                        X                         X                          X                        X
X                        X                         X                          X                        X
X                        X                         X                          X                        X
X                        X                         X                          X                        X
X                        X                         X                          X                        X
X                        X                         X                          X                        X
X                        X                         X                          X                        X
X                        X                         X                          X                        X
X                        X                         X                          X                        X
XXXXXXXXXXXXXXXXXXXXXXXXXXXXXXXXXXXXXXXXXXXXXXXXXXXXXXXXXXXXXXXXXXXXXXXXXXXXXXXXXXXXXXXXXXXXXXXXXXXXXXXX